[000000],
[011110],
[015110],
[231110],
[423110],
[442000],
