[0,0,0,0,0,0],
[0,1,1,1,1,0],
[0,1,5,1,1,0],
[2,3,1,1,1,0],
[4,2,3,1,1,0],
[4,4,2,0,0,0],
